1,1,0,0,0,0,0,0,1,0,0,0,1,0,9,9
1,1,1,1,1,0,1,1,1,1,1,1,1,1,1,0
0,1,0,1,0,0,1,0,1,0,0,6,0,0,0,0
0,2,1,1,1,1,1,0,1,3,2,0,6,8,0,0
0,2,0,1,0,1,0,0,1,0,0,4,0,0,0,0
0,0,2,1,0,0,0,0,1,2,3,0,0,9,9,0
0,1,1,1,1,1,1,0,1,2,0,0,5,0,0,9
0,1,0,1,0,0,0,0,0,1,3,0,7,7,7,0
0,1,3,1,1,1,1,1,1,4,0,7,7,7,0,8
1,1,3,1,0,0,0,1,0,0,7,0,0,6,0,8
0,0,0,1,0,0,0,1,0,4,0,4,0,6,8,8
0,0,0,3,3,0,0,1,0,0,0,0,6,0,8,8
0,0,0,1,0,0,0,1,0,0,0,6,0,8,8,0
0,0,0,1,0,0,0,1,0,0,0,0,0,8,8,0
0,0,0,1,0,0,0,1,0,0,0,0,0,0,0,0
